NO ./textures/Player.xpm
SO ./textures/Player.xpm
F 255,255,255
C 255,255,255
WE ./textures/Player.xpm
EA ./textures/Player.xpm


1111111111111111     111
10000000N0000001     101
1111111111111111     111
