NO textures/north.xpm
SO textures/south.xpm
WE textures/west.xpm
EA textures/east.xpm
F 150,90,60
C 70,130,180

1111111111111111111111111111111111111111
1000000000000000001000000000000000000001
1000000000000000001000000000000000000001
1000000000000000001000000000000000000001
1000000111100000001000001111100000000001
1000000100000000001000001000000000000001
1000000100000000001000001000000000000001
1000000111100000000000001111100000000001
1000000000000000000000000000000000000001
1000000000000000000000000000000000000001
1111111000011111111111111000011111111111
1000000000000000000000000000000000000001
1000000000000000000000000000000000000001
1000001111100000000000001111000000000001
1000001000000000001000001000000000000001
1000001000000000001000001000000000000001
1000001111100000001000001111000000000001
1000000000000000001000000000000000000001
1000000000000000001000000000000000000001
1000000000000000001000000000000000000001
1000000000000S00001000000000000000000001
1111111111111111111111111111111111111111
