NO textures/north.xpm
SO textures/south.xpm
WE textures/west.xpm
EA textures/east.xpm
F 40,40,40
C 20,20,60

1111111111111111111111111
1000000000100000000000001
1011111010101111111111101
1010000010100000000000101
1010111110101111111110101
1010100000100000000010101
1010101111111111101010101
1010101000000000101010101
1010101011111110101010101
1010101010000010101010101
1010101010111010101010101
1010001010100010101010101
1011101010101110101010101
1000001010100000101010001
1011111010111111101011101
1010000010000000001000101
1010111011111111111110101
1010001000000000000010101
1010101111111111101010101
1010100000000000101010101
10101111111111101010N0101
1000000000000000100000101
1111111111111111111111111
