NO textures/north.xpm
SO textures/south.xpm
WE textures/west.xpm
EA textures/east.xpm
F 180,140,100
C 100,160,220

111111
100001
10E001
100001
111111
