NO textures/north.xpm
SO textures/south.xpm
WE textures/west.xpm
EA textures/east.xpm
F 220,100,0
C 135,206,235

111111111111
100000000001
101111100001
100000100001
100000100001
100N00000001
100000110001
100000000001
111111111111
